7,7,7,7,7,7,7,7,7,7,7
7,2,1,2,1,2,1,2,1,6,7
7,1,2,1,2,1,2,1,2,1,7
7,2,1,2,1,2,1,2,1,2,7
7,1,2,1,2,1,2,1,2,1,7
7,2,1,2,1,2,1,2,1,2,7
7,1,2,1,2,1,2,1,2,1,7
7,2,1,2,1,2,1,2,1,2,7
7,1,2,1,2,1,2,1,2,1,7
7,2,1,2,1,2,1,2,1,2,7
7,1,2,1,2,1,2,1,2,1,7
7,2,1,2,1,2,1,2,1,2,7
7,1,2,1,2,1,2,1,2,1,7
7,2,1,2,1,2,1,2,1,2,7
7,1,2,1,2,1,2,1,2,1,7
7,2,1,2,1,2,1,2,1,4,7
7,1,2,1,2,1,2,1,2,1,7
7,2,1,2,3,4,3,2,1,2,7
7,0,2,3,2,1,2,1,2,1,7
7,0,0,2,1,2,1,2,1,4,7
7,7,7,7,7,7,7,7,7,7,7