7,10,10,10,10,10,10,10,8
7,1,2,1,2,1,2,6,8
7,2,1,2,3,2,1,2,8
7,1,4,1,2,3,4,3,8
7,2,1,2,1,2,1,2,8
7,1,2,1,2,1,2,1,8
7,2,1,2,1,2,1,2,8
7,1,2,3,4,1,2,1,8
7,2,1,4,3,2,1,2,8
7,1,2,1,2,1,2,1,8
7,4,3,2,1,2,1,2,8
7,3,4,1,2,1,4,1,8
7,2,1,2,1,2,3,2,8
7,1,2,1,2,1,4,1,8
7,0,1,2,3,2,1,2,8
7,9,9,9,9,9,9,9,8